
 A tal punto -- At such a point 
Por mi parte 
Según las fuentes -- According to sources 
a continuación -- then
a ese respecto -- in this/that regard, on that score
a la caza de -- in the hunt for
a la vez que -- at the same time that
a lo largo -- along, offshore, lengthwise, in the distance
a lo que -- what
a medida que -- ?
a nadie le gusta -- nobody likes it
a nuestro gusto -- at our pleasure, to our liking
a punto de -- on the point of
a tal efecto -- to that effect
a tal efecto en el que -- to that effect in which
a tan solo -- to just/only
afectados por -- affected by
al hacer esto -- by doing this
al parecer -- apparently
alguien más -- anyone else
alguno de esos -- any of those
apoyado en su artillería de largo -- supported by their long range artillery/ordnance (ie the team shot really well from three ... kind of how we might say they were BOMBING from three)
argumentalmente hablando -- arguably speaking
aún más -- even more
cada uno de estos -- each one of these
capaz de cualquier cosa -- capable of anything
como debería ser -- as it should be
como era de esperar -- as expected
como tal -- as such
como ya sabéis -- as you already know
con mayor frecuencia -- more often than
correr el riesgo
cuenta con -- has
da más pie al
de esta manera -- in this way
de lo contrario -- on the contrary
de manera resumida -- briefly
debe estar a la altura -- must be up to par
desde hace más de -- for more than
desde luego -- of course
después de haber regresado de -- after returning from/after having returned from ?
después de tantos años -- after so many years
difícil de entender
en alguna de las frases -- in some of the phases
en casi todos los casos -- in most of the cases
en contra -- against
en definitiva -- definitely,
en este sentido
en principio -- at first, in principle, before
en promedio -- on average
en tan solo -- in just/only
en términos -- in terms (of)
es bastante -- it is quite
es muy importante que
este o aquel
haberlas las hay -- there are
hace unos meses -- a few months ago
hasta ahora -- until now
lista para -- ready for
los que no -- those who do not
mucho más atrás -- much further back
más allá -- beyond
más que nunca -- more than ever
método de ensayo y error -- trial and error method
ni mucho menos -- no less
no en exceso -- not in excess
no falta de nada -- there is nothing missing
no hay una fórmula mágica -- there is no magic formula
no se andan con chiquitas -- they do not hang out with little girls (no idea what this actually means)
no sé ni por dónde empezar.
nos sentimos como en casa -- we felt right at home
nunca mejor dicho
o tal vez -- or maybe
pero a la vez -- but at the same time
pero aun con esas -- but even with those
pero eso fue todo -- but that was all
pero está lejos de ser bueno -- but it is far from being good
pero lo hay -- but there is
pero ya -- but now
pese a que -- although
pone en suspenso -- puts on hold
por desgracia -- unfortunately
por norma general
por sí mismos -- for themselves
pues bien -- as well
que como decíamos antes -- that as we said before, like as we said before
que hacen que -- that make
que lo son -- that they are
que podremos encarnar -- that we can embody
que ya hay de por sí -- which already exists in itself
saltó a pista -- jumped on the track ? 
sentido común -- common sense
si de algún modo -- if in any way
si no me equivoco -- if i'm not mistaken
siempre quieres más.
sigue siendo -- remains
sin entrar en -- without getting into the details
sino el qué y el cómo --?
sobre toda a la hora de -- especially at the time of
sufrir cambios -- undergo changes
tal vez -- maybe perhaps
tal y como -- just like
también hay algunas cosas -- also there are some things
te parece que -- do you think that
tenía que gustar sí o sí --?
todo en su sitio -- everything in (its) place
todos aquellos que -- all who, all those that
una vez
una vez más
unos u otros
vamos a notar -- let's notice
without noticing -- without noticing
y como no -- and as
ya que -- as, since, inasmuch as, being that, insomuch as
¿como cuales?
¿se le puede pedir más? -- can one ask for more
No pasaba nada -- nothing was happening 
Más que nada -- more than anything